NO ./textures/red.xpm
SO ./textures/red.xpm
WE ./textures/purplestone.xpm
EA ./textures/greystone.xpm

F 200,130,20
C 80,225,50

        1111111111111111111111111
        1000000001110000000000001
        10000000011100000000000011111111111111111111111111111111111111111111111111111
        10000000011100000000000000000000000000000000000000000000000000000000000000001
1111111110000000011100000000000011111111111111111111111111111111111111111111111111101                                               
1000000000000000011101111111111111111111111111111111111111111111111111111111111111101
1000000000000000000000001000111111111111111111111111111111111111111111111111111111101
1000000000000000000000000000111111111111111111111111111111111111111111111111111111101
1000000000000000000000000000111111111111111111111111111111111111111111111111111111101
10000N0000000000000000000000111111111111111111111111111111111111111111111111111111101
1000000000000000000000000000111111111111111111111111111111111111111111111111111111101
1000000000000000000000000000000000000000000000000000000000000000000000000000000000001
1000000000000000000000000000111111111111111111111111111111111111111111111111111111111
1111111111111111111111111111111111111111111111111111111111111111111111111111111111111






