NO ./textures/red.xpm
SO ./textures/eagle.xpm
EA ./textures/greystone.xpm

F 220,100,0

WE ./textures/purplestone.xpm
C 190,205,203

         11111111111111111111111 
        1000000000110000000000001
        1011000001110000000000001
        1001000000000000000000001
111111111011000001110000000000001
100000000011000001110111111111111
11110111111111011100000010001
11110111111111011101010010001
10000000110101011100000010001
10000000000000000000000010001
100E0000000000000001010010001
1000000111010101111101111000111
10000001 1110101 101111010001
11111111 1111111 111111111111
