NO      ./textures/red.xpm
SO ./textures/red.xpm
WE ./textures/purplestone.xpm
EA ./textures/greystone.xpm

F      90,130,20

C 50,50,50

        1111111111111111111111111
        1000000001110000000000001
        10000000011100000000000011111111111111111111111111111111111111111111111111111
        10000000011100000000000000000000000000000000000000000000000000000000000000001
1111111110000000011100000000000011111111100111111111111111011111111111111111111111101
1000000000000000011101111111111111111111100111111111111111011111000000000000011111101
1000000000000000000000001000111111111111100000000000000000011111000000000000011111101
1000000000000000000000000000111111111111100000000000000000000000000000000000011111101
1000000000000000000000000000111111111111100111111111111110011111000000000000011111101
1000000000N00000000000000000111111111111100111111111111110011111000000000000011111101
1000000000000000000000000000111111111111100111111111111110011111111111111111111111101
1000000000000000000000000000000000000000000000000000000000000000000000000000000000001
1000000000000000000000000000111111111111111111111111111111111111111111111111111111111
1111111111111111111111111111111111111111111111111111111111111111111111111111111111111
