NO ./textures/purplestone.xpm
SO ./textures/purplestone.xpm
WE ./textures/wall.xpm
EA ./textures/greystone.xpm

F 220,100,0
C 98,190,45

11111111111111111111111   11111111111111111111
10000000000000000000001   10000000000000000001
10000000000000000000001   10000000000000000001
10000000000000000000001   10000000000000000001
10000000000000000000001   10001111111111110111
10000000000000000000001   10001          101
10000000000000000000001111100011111111111101
1000E000000000000000000000000000000001000001
10000000000000000000000000000000000001000001
11111111111111111111111111111111111111000001
10000000000000000000010000000000000000000001
10000000000000000000010000000000000000000001
10000000000000000000010000000000000000000001
10000000000000001000010000000000000000000001
10000000000000001000000000000000000000000001
10000000000000001111111000000000000000000001
10000000000000000000001111111111111111111111
11111111111111111111111
